1111111111111111111111111111
1222222112222222222112222221
1311112112111111112112111131
1211112112111111112112111121
1222222222222222222222222221
1112112111112112111112112111
1112112111112112111112112111
1112112111112112111112112111
0002112222222112222222112000
1112111110111111110111112111
1112111110111111110111112111
1112000000000000000000002111
1112111110111411110111112111
1112111110111411110111112111
1112110000144444410000112111
1112110110111111110110112111
1112110110111111110110112111
0002000110000000000110002000
1112111111110110111111112111
1112111111110110111111112111
1112222222000110002222222111
1112111112111111112111112111
1112111112111111112111112111
1222222222222002222222222221
1211112111112112111112111121
1211112111112112111112111121
1211112112222112222112111121
1311112112111111112112111131
1211112112111111112112111121
1222222222222222222222222221
1111111111111111111111111111