1111111111111111111111111111
0000000112222222222110000000
1111110112111111112110111111
1111110112111111112110111111
1322222222222112222222222231
1211111112112112112111111121
1211111112112112112111111121
1211222220112112112222221121
1211211110112222110111121121
1211211110111111110111121121
1222222110111111110112222221
1111112110000000000112111111
1111112110111411110112111111
1222222110111411110112222221
1211112110144444410112111121
1211112000144444410002111121
1222112110111111110112112221
1112112110000000000112112111
1112112111101111011112112111
1112112111101111011112112111
1112222222221111222222222111
1112111111121111211111112111
1112111111121111211111112111
0002222112220000222112222000
1112112112111111112112112111
1112112112111111112112112111
1322112222222112222222112231
1211112111112112111112111121
1211112111112112111112111121
1222222222222222222222222221
1111111111111111111111111111

