1111111111111111111111111111
1222222222112222112222222221
1211111112112112112111111121
1311111112112112112111111131
1211222222222112222222221121
1211211211112112111121121121
1222211211112112111121122221
1111211211112112111121121111
1111211222222222222221121111
0222211110111111110111122220
1211011110111111110111101121
1211000000000000000000001121
1211110110111411110110111121
1211110110111411110110111121
1200000110144444110110000021
1211011110144444110111101121
1211011110111111110111101121
1211000000000000000000001121
1211110111110110111110111121
1211110111110110111110111121
1222222112222112222112222221
1112112112111111112112112111
1112112112111111112112112111
1322112222222002222222112231
1211112111112112111112111121
1211112111112112111112111121
1222222112222112222112222221
1211112112111111112112111121
1211112112111111112112111121
1222222112222222222112222221
1111111111111111111111111111